5
BBBBBBBBBBBBBBBBBBBBBB
BSSS   SSS   SSS   SSB
B SSS   SSS   SSS   SB
B  SSS   SSS   SSS   B
B                    B
B                    B
B                    B
B                    B
B                    B
B                    B
B                    B
B                    B
B                    B
B                    B
B                    B
B                    B
B                    B
B                    B
B                    B
B                    B
B                    B
B                    B
B                    B
B                    B
B                    B
B                    B
B                    B
B                    B
B                    B
B                    B
